1111111
1PCE111
1111C11
1111111