111111111111111111111111111
1E0000000000000C00000C00001
1P1000001C00C00000J000000C1
100000001C00C000000000000C1
100000010C00C0000000J0000C1
1J0000100C00C000000000000C1
100001000C00C00000J000000C1
111111111111111111111111111